{
    "user":{
        "x":0,
        "y":0,
        "access":["."]
    },
    "end":{
        "x":7,
        "y":11
    },
    "map":[
        [".","f",".",".",".",".",".",".",".",".",".",".",".","."],
        [".","f",".","f","f","f","f","f","f","f","f","f","f","."],
        [".","f",".","f",".",".",".",".",".",".",".",".","f","."],
        [".","f",".","f",".","f","f","f","f","f","f",".","f","."],
        [".","f",".","f",".","f",".",".",".",".","f",".","f","."],
        [".","f",".","f",".","f",".","f","f",".","f",".","f","."],
        [".","f",".","f",".","f",".","f","f",".","f",".","f","."],
        [".","f",".","f",".","f",".","f","f",".","f",".","f","."],
        [".","f",".","f",".","f",".","f","f",".","f",".","f","."],
        [".","f",".","f",".","f",".","f","f",".","f",".","f","."],
        [".","f",".","f",".","f",".","f","f",".","f",".","f","."],
        [".","f",".","f",".","f",".",".","f",".","f",".","f","."],
        [".","f",".","f",".","f","f","f","f",".","f",".","f","."],
        [".","f",".","f",".",".",".",".",".",".","f",".","f","."],
        [".","f",".","f","f","f","f","f","f","f","f",".","f","."],
        [".","f",".",".",".",".",".",".",".",".",".",".","f","."],
        [".","f","f","f","f","f","f","f","f","f","f","f","f","."],
        [".",".",".",".",".",".",".",".",".",".",".",".",".","."]
    ]
}
