{
    "user":{
        "x":0,
        "y":0,
        "access":["."]
    },
    "end":{
        "x":6,
        "y":9
    },
    "map":[
        [".","~","~","~","~","~","~"],
        [".",".",".",".","~","~","~"],
        ["f","f","f",".","~","~","~"],
        ["f","f","f",".","~","~","~"],
        ["f","f","f",".","~","~","~"],
        ["f",".",".",".","~","~","~"],
        ["f",".","f","f","~","~","~"],
        ["m",".","m","m","~","~","~"],
        ["f",".","f","f","~","~","~"],
        ["f",".",".",".",".",".","."],
        ["f","f","f","f","~","~","~"]
    ]
}
