{
    "user":{
        "x":0,
        "y":0,
        "access":["."]
    },
    "end":{
        "x":10,
        "y":10
    },
    "map":[
        [".",".","~","~","~","~","f",".",".",".",".","~"],
        [".",".","~","~","~","~","f",".",".",".",".","~"],
        ["f","f",".",".",".",".",".",".",".",".",".","~"],
        ["M","f","f",".","~","~","~","~",".",".",".","~"],
        ["M","M","f","f","f","~",".","M",".",".",".","~"],
        ["M","M","M",".",".","~","t","f",".",".",".","~"],
        ["f","M","M",".",".","~","t","f",".",".",".","~"],
        ["M","M","M",".",".","~","t","f",".",".",".","~"],
        ["M","M","f","f","f","~",".","M",".",".",".","~"],
        ["M","f","f",".","~","~","~","~",".",".",".","~"],
        ["f","f",".",".",".","~","f",".",".",".",".","~"],
        [".",".","~","~","~","~","f",".",".",".",".","~"],
        [".",".","~","~","~","~","f",".",".",".",".","~"]
    ]
}
