{
    "user":{
        "x":0,
        "y":0,
        "access":["."]
    },
    "end":{
        "x":3,
        "y":1
    },
    "map":[
        [".","f",".",".",".",".","f",".",".",".",".",".",".","."],
        [".","f","*","f","f",".","f",".","f","f",".","f","f","."],
        [".","f","f","f","f",".","f",".","f","f",".","f","f","."],
        [".","f","f","f","f",".","f","f","f","f",".","f","f","."],
        [".","f","f","f","f",".",".",".",".",".",".","f","f","."],
        [".",".",".",".","f","f","f","f","f","f",".","f","f","."],
        [".","f","f",".","f",".",".",".","f","f",".","f","f","."],
        [".","f","f",".","f",".","f",".","f","f",".","f","f","."],
        [".","f",".",".","f",".","f",".","f","f",".","f","f","."],
        [".","f",".",".","f",".","f",".","f","f",".","f",".","f"],
        [".","f","f","f","f","f","f",".","f","f",".","f",".","f"],
        [".","f","f","f","f","f","f",".","f","f",".","f",".","f"],
        [".",".",".",".",".",".",".",".","f","f",".","f",".","f"],
        [".","f","f","f","f","f","f",".","f","f",".","f",".","f"],
        [".","f","f","f","f","f","f",".",".",".",".","f","f","f"],
        [".","f","f","f","f","f","f","f","f","f",".",".",".","f"],
        [".","f","f","f","f","f","f","f","f","f","f","f","f","f"],
        [".",".","f","f","f","f","f","f","f","f","f","f","f","f"]
    ]
}
